1111111111111
10C10000000C1
1100011111001
1P0001E000001
1111111111111
